NO ./wall.png
SO ./wall.png
WE ./wall.png
EA ./wall.png

F 220,100,0
C 225,30,0


        1111111111111111111111111
        1000000000110000000000001
        1011000001110000000000001
        1001000000000000000000001
1111111110110000011100000D0000001
100000000011000001110111111111111
11110111111111011100000010001
11110111 11111011101010010001
11000000110101011100000010001
10000000000000000000000010001
10000000000000001101010010001
11000001110101011111011010N01
11110111 1110101 101111000001
11111111 1111111 111111111111