NO  textures/wall_1.png
SO textures/wall_3.png
F 125,30,55
C                 5,11,5
WE textures/wall_2.png
EA textures/wall_1.png


111111111111111111111111 111
10000000001100000000000011001
10110000011100000000000010001
10010000000000000000000010001
10110000011100000000000010001
10000000001100000111011110001
11110111111111011100000010001
11110111110111011101010010001
11000000110101011100000010001
10000000000S10001100000010001
111111111111011111111111111111
11111111111101011111111111111
11111111111101111111111111111
100000000000000011010100100001
11000000110101000000000000001
11110111110101000000000000001
1000000000110000100000010001
10000000000000001010000101001
10000000001000010001010001001
1000000000110100000000000001
10000000000100000001010000001
11111111111111111111111111111
111111111111 11111111111111111
