

SO ./path_to_the_south_texture
NO ./path_to_the_north_texture
EA ./path_to_the_east_texture
WE ./path_to_the_west_texture



C 225,30,0
F 220,100,0               
              



     11111111111111111111111111111
11111000011000000000000111111 11    
10110000011100000000000101111111
1001000000000000000000001
111111111011000001110000000000001
    100000000011000001110111111111111
11110111111111011100000010001
111111111111111111111111111111111111

111111111111111111111111111111111111
11110111111111011101010010001
11000000110101011100000010001                    
10000000P00000001100000010001
10000000000000001101010010001
11000001110101011111011110N0111
11110111 1110101 101111010001
11111111 1111111 111111111111






