
NO ./path_to_the_north_texture
SO ./path_to_the_south_texture
WE ./path_to_the_west_texture
EA ./path_to_the_east_texture

F 220,100,0
C 225,30,0

        11111111111111111111111111
        100000000110000000000001
        1011000001110000000000001
        1001000000000000000000001
111111111011000001110000000000001
100000000011000001110111111111111
11111111111111011100000010001111111111111111111111111111111111
        11110111111111011101010010001
1111111111111111110101011100000010001
100000000000000011000000100011111111
100000000000W00011010100100001
110000011101010111110111100011
1111011111101011011110100011
11111111111111111111111111            