NO  ./path_to_the_north_texture
SO ./path_to_the_south_texture
C                 5,21,5
F 225,30,0
WE ./path_to_the_west_texture
EA ./path_to_the_east_texture



11111111111111111111111
111111111111000000001
111111E11111111111111
11111111111111111111111