F 220
C 225,30,32

NO ./path_to_the_north_texture
SO ./path_to_the_south_texture
WE ./path_to_the_west_texture
EA ./path_to_the_east_texture



           
111111111111111111111111             
                111111111111111111111
        111111111111111111111111111
1111111111000000000000001
10110000011100000000000011111111111
1001000000000000000000001
1111111111111111111111111111111111111111111111
1111111110110000011111111                              
100000001111111111111
100000000011000001110111111111111
1111011111111011100000010001
11111111111111011101010010001111111111
        11000000110101011100000010001
111111111111111100000001111111111111111
            1111000000011111111111111111
111111111111111111111111111
1000000000000001101010010001
11000001110101011111011110N0111
11111111111111111111111111111




