F 220
C 225,30,32

NO ./path_to_the_north_texture
SO ./path_to_the_south_texture
WE ./path_to_the_west_texture
EA ./path_to_the_east_texture




                                                            
111111111111111111111111             
                111111111111111111111
1111101111111111111111111
1100000000011000000000000001
1011000001110000000000001
1001000000000000000000001
1111111111111111111111111111111111111111111111
1111111110110000011100001
100000001
100000000011000001110111111111111
     1111011111111011100000010001
11110111111111011101010010001
        11000000110101011100000010001
1111111111111111000000011111111
            1111000000011111111111111111
111111111111111111111111111
1000000000000001101010010001
11000001110101011111011110N0111
11111111111111111111111